NO textures/test/north.xpm
SO textures/test/south.xpm
WE textures/test/west.xpm
EA textures/test/east.xpm

F 4,84,109
C 229,255,254

11111
10001
10001
10001
10001
10001
11001
10001
10001
10001
10001
10001
11111
