NO ./texture/wall_north.xpm
SO ./texture/wall_south.xpm
WE ./texture/wall_west.xpm
EA ./texture/wall_east.xpm

F 4,84,109
C 229,255,254

111111111111111111111
1W0000000000000000001
111111111111111111111
